##########
#O   #  @#
#    #   #
#    #   #
#   $    #
#    #   #
#    #   #
##########
