##########
#O       #
#        #
#  $     #
#        #
#   @    #
#        #
##########
