##########
#O       #
#   #    #
#        #
#   #  $ #
#        #
########@#
       ###
